BBBBBBBBBBBBB
B-----------B
B-----------B
BP---S--S---B
BBBBBBBBBBBBB