BBBBBBBB
B------B
B------B
BP----SB
BBBBBBBB