BBBBBBBBBBBBBBBBBB
BBB------------BBB
BB--------------BB
B----------------B
BP-------G-------B
BBBBBBBBBBBBBBBBBB