BBBBBBBBBBBBBBBBBB
B----------------B
B----------------B
BP---S--S--S-S--SB
BBBBBBBBBBBBBBBBBB