BBBBBBBBBBBB
B----------B
B----------B
BP--------KB
BBBBBBBBBBBB